                                                       
       |===========|                                   
=>$+++++***********|                                   
       |***********|                                   
       |=====+=====|                                   
             +                                         
            |=+===========|                            
            |*************+++++           +++END       
            |****R********|   +           +            
            |*************|   +   |=======+==|         
            |********B****|   +  ++**********|         
            |=====+=======|   ++++|*****S****|         
                  +              +|**********|         
                  ++++++++++++++++|==========|         