         |==========|                                  
=>$+++++++***R******|                                    
         |**********|                                  
         |========+=|                                  
                  +                                    
                |=+===========|                        
                |*************|                        
                |****R********|                        
                |*************|                        
                |=====+=======|                        
                      +                                
                      ++++++++++++++++++END            
                                                     