                                                  
                               |=============|    
START=>$+                      |*************++++END    
        ++                     |*************|    
        ++                     |*************|    
        +                      |===========+=|    
      |=+===========|                     ++      
      |*************++++++                 +      
  ++  |****R********|   ++                 ++     
+++++++*************|   ++         |========+=|   
      |********B****|   +          |**********|   
      |=====+=======|   ++++++++++++**********|   
            +++++++++++++          |==========|   
