                                                  
                               |=============|    
=>$++++++                      |*************++++END    
        +                      |*************|    
        +                      |*************|    
        +                      |===========+=|    
      |=+===========|                     ++      
      |*************+++++                  +      
      |****R********|   +                  ++     
+++++++*************|   +          |========+=|   
      |********B****|   +          |**********|   
      |=====+=======|   ++++++++++++**********|   
            +++++++++++++          |==========|   
